WE ./textures/green_empty.png
SO ./textures/dog.png
NO ./textures/Bone.png
EA ./textures/Grass.png

F 252,100,0
C 225,30,0

111111
1001011111111    11
10111       11  1001
1100E11111111    11
111111111