NO ./path_to_the_north_texture
SO ./path_to_the_south_texture
WE ./path_to_the_west_texture
EA ./path_to_the_east_texture

F 0,120,180
C 170,30,20

111111111
101000001
1010N0101
100000101
111111111
