WE ./textures/green_empty.png
SO ./textures/dog.png
NO ./textures/Bone.png
EA ./textures/Grass.png

F 150,100,100
C 0,80,120


111111
1001011111111    11
10111       11  1001
1100E11111111    11
111111111