NO ./textures/colorstone.png
SO ./textures/greystone .png
WE ./textures/wood.png
EA ./textures/eagle.png


     

F 211,211,211
C 0,191,255

        1111111111111111111111111
        1000000000110000000000001
        1011000001110000000000001
        1001000000000000000000001
111111111011000001110000000000001
100000000011000001110111111111111
11110111111111011100000010001
11110111111111011101010000001
11000000110101011100000010001
10000000000000S00000000010001
10000000000000001101010010001
110000011101010111110111100111
11110111 1110101 101111010001
1111111111111111 111111111011
10000000000000001101010010001
110000011101010111110111100111
11110111 1110101 101111010001
1111111111111111 111111111011
10000000000000001101010010001
110000011101010111110111100111
11110111 1110101 101111010001
1111111111111111 111111111011
10000000000000001101010010001
110000011101010111110111100111
11110111 1110101 101111010001
1111111111111111 111111111011111111111111111111111111111111111111111
10000000000000001101010010000000000000000000000000000000000000000001
11000001110101011111011110011111111111111111111111111111111111111111
11110111 1110101 101111010001
1111111111111111 111111110111
10000000000000001101010010001
110000011101010111110111100111
11110111 1110101 101111010001
11111111 1111111 111111111111