NO ./textures/redbrick.png
SO ./textures/redbrick.png
WE ./textures/eagle.png
EA ./textures/eagle.png

F 0,120,180
C 170,30,20

1111111111111
1111111111111
1010W01111111
10000001 1001
1111101111111
100000001
111111111